0 1 20 18 20 19 20 19 18 1 0 18 18 1 18 2 18 19 1 18 0 18 1 1 18 19 19 1 0 19
0 20 19 19 1 2 0 1 2 18 1 1 19 0 20 19 18 20 20 1 2 0 2 20 18 56 57 2 0 18
1 20 0 56 57 19 1 20 1 19 18 1 20 2 2 19 20 18 1 19 0 9 10 10 11 74 75 18 18 18
2 2 1 74 75 19 20 20 2 18 19 0 0 2 1 19 19 2 1 2 18 27 28 28 29 74 75 19 18 19
18 0 0 74 75 0 1 19 1 2 1 19 20 2 0 20 19 20 0 18 19 27 28 28 29 74 75 19 19 2
0 1 1 74 75 1 19 1 2 19 1 2 0 2 20 18 2 18 20 18 19 27 28 28 29 74 75 19 20 2
2 20 1 74 75 19 0 19 1 90 91 91 91 91 91 91 91 91 57 18 1 27 28 28 29 74 75 19 1 20
18 1 20 74 75 0 20 2 20 108 109 109 109 109 109 109 109 110 75 19 9 104 28 28 29 74 75 20 0 0
0 1 18 74 75 18 1 1 2 0 0 2 20 19 18 19 1 74 75 19 27 28 28 28 29 74 75 2 20 2
1 19 19 74 75 1 18 0 19 19 19 2 0 18 9 10 11 74 75 0 27 28 28 28 29 74 75 0 18 20
2 2 18 74 75 1 0 18 2 1 18 1 0 0 27 28 29 74 75 18 45 46 46 46 47 74 75 19 19 0
19 0 1 74 75 19 2 18 18 2 2 1 1 19 45 46 47 74 75 18 1 18 19 0 19 74 75 18 2 1
19 19 18 74 93 94 94 94 94 94 94 94 91 91 91 91 91 92 93 91 91 91 91 91 91 92 75 1 19 18
1 19 2 146 112 112 112 112 112 112 112 112 109 109 109 109 109 110 111 109 109 109 109 109 109 110 75 2 18 20
19 18 18 18 1 19 1 18 0 2 2 18 18 19 2 0 1 74 75 20 1 18 18 2 2 74 75 1 2 20
18 0 19 1 1 2 20 19 20 18 2 18 18 1 1 20 2 74 75 18 1 18 2 19 20 74 75 0 0 0
1 18 19 20 1 18 18 20 1 20 0 2 0 19 0 1 2 74 93 91 91 91 91 91 91 92 75 0 1 0
2 1 1 19 18 0 0 2 18 2 18 19 19 18 1 20 1 108 109 109 109 109 109 109 109 112 113 1 20 1
19 18 20 2 2 1 2 19 19 2 0 19 0 0 1 19 19 2 2 2 2 18 20 20 18 0 19 20 18 0
1 19 18 19 20 2 2 19 20 20 18 19 2 18 19 1 18 18 1 18 20 2 1 19 19 18 2 2 1 18
